가슴이 찡하다 - Feel touched
간이 크다 - Be fearless
간이 콩알만 해지다 - Be scared stiff
같은 값이면 다홍치마 - Prefer the better option
개천에서 용 난다 - Rise from humble beginnings
고생 끝에 낙이 온다 - No pain, no gain
골머리를 썩이다 - Rack one’s brain
귀가 얇다 - Be easily swayed
그림의 떡 - Pie in the sky
금강산도 식후경 - First eat, then enjoy
깨가 쏟아지다 - Be lovey
난다 긴다 하다 - Be outstanding
낮말은 새가 듣고 밤말은 쥐가 듣는다 - Walls have ears
누워서 떡 먹기 - Piece of cake
다람쥐 쳇바퀴 돌듯 - Stuck in a rut
도토리 키 재기 - Much of a muchness
돌다리도 두들겨 보고 건너라 - Look before you leap
등골이 오싹하다 - Feel a chill down one’s spine
땅을 치고 후회하다 - Regret bitterly
말이 씨가 된다 - Words can come true
모르는 게 약이다 - Ignorance is bliss
바가지를 씌우다 - Rip someone off
발 벗고 나서다 - Go all out
발등에 불이 떨어지다 - Be pressed for time
배보다 배꼽이 더 크다 - The tail wagging the dog
벼는 익을수록 고개를 숙인다 - The wiser, the humbler
비 온 뒤에 땅이 굳어진다 - What doesn’t kill you makes you stronger
사서 고생하다 - Ask for trouble
산 넘어 산 - One hurdle after another
새 발의 피 - A drop in the ocean
세월이 약이다 - Time heals all wounds
속이 타다 - Be anxious
쇠뿔도 단김에 빼라 - Strike while the iron is hot
식은 죽 먹기 - Easy as pie
심장이 철렁하다 - Heart skips a beat
애를 먹다 - Have a hard time
오리발 내밀다 - Play innocent
울며 겨자 먹기 - Bite the bullet
쥐구멍에도 볕 들 날 있다 - Every dog has its day
티끌 모아 태산 - Many a little makes a mickle
가려운 곳을 긁어 주다 - Hit the spot
가시방석에 앉다 - Walk on eggshells
가슴에 못을 박다 - Break someone’s heart
가슴을 치다 - Beat one’s chest
개밥에 도토리 - Be an outcast
국수를 먹다 - Get married
귀가 솔깃하다 - Be all ears
귀에 못이 박히다 - Hear it a million times
기가 막히다 - Be at a loss for words
깨가 서 말이다 - Be full of love and happiness
낯이 두껍다 - Be shameless
눈 깜짝할 사이 - In the blink of an eye
눈 밖에 나다 - Fall out of favor
눈 딱 감다 - Take the plunge
눈에 불을 켜다 - Be eager
눈엣가시 - Thorn in one’s side
다리가 후들거리다 - Legs turn to jelly
도마 위에 오르다 - Be under scrutiny
돈방석에 앉다 - Be rolling in money
등이 휠 정도로 일하다 - Work one’s fingers to the bone
등을 돌리다 - Turn one’s back on
마음을 졸이다 - Be on edge
모래알 같은 존재 - Feel insignificant
물불 가리지 않다 - Stop at nothing
발이 넓다 - Be well
배꼽 잡고 웃다 - Laugh one’s head off
벽에 부딪히다 - Hit a wall
불 보듯 뻔하다 - Be as clear as day
불난 집에 부채질하다 - Add fuel to the fire
비행기를 태우다 - Flatter excessively
속이 보이다 - Be transparent (in behavior)
속을 긁다 - Get on someone’s nerves
속이 뒤집히다 - Feel sick to one’s stomach
숨이 턱 막히다 - Be breathtaking
시치미를 떼다 - Play dumb
쓴맛을 보다 - Learn the hard way
아쉬운 대로 - Make do
알다가도 모르겠다 - Can’t make sense of it
애간장을 태우다 - Be in agony
어깨를 으쓱하다 - Shrug off
얼굴이 두껍다 - Have a thick skin
입이 짧다 - Be a picky eater
쥐 죽은 듯이 조용하다 - Be dead silent
찬물을 끼얹다 - Rain on someone’s parade
참새가 방앗간을 그냥 지나치지 않는다 - Can’t resist temptation
코가 납작해지다 - Be humiliated
콧대가 높다 - Be stuck
파김치가 되다 - Be exhausted
하늘이 노래지다 - Feel dizzy
한눈을 팔다 - Be distracted
한솥밥을 먹다 - Work/live together
허리띠를 졸라매다 - Tighten one’s belt
허를 찌르다 - Catch someone off guard
혀를 내두르다 - Be astonished
호랑이도 제 말 하면 온다 - Speak of the devil
호랑이 굴에 들어가야 호랑이를 잡는다 - No risk, no reward
화를 부르다 - Bring trouble upon oneself
힘을 빼다 - Take it easy
입에 발린 말을 하다 - Sweet
입이 무겁다 - Keep a secret
가닥을 잡다 - Get the hang of it
가뭄에 콩 나듯 - Once in a blue moon
가시밭길을 가다 - Walk a thorny path
간담이 서늘하다 - Be scared to death
개미 새끼 하나도 볼 수 없다 - Not a soul in sight
게 눈 감추듯 - Disappear in an instant
고개를 갸웃하다 - Tilt one's head in doubt
고개를 숙이다 - Show humility
고배를 마시다 - Taste failure
골탕을 먹다 - Get the short end of the stick
국물도 없다 - No chance at all
귀신이 곡할 노릇 - Unbelievable
그림자가 어른거리다 - See a shadow (of doubt, suspicion)
기가 죽다 - Lose confidence
까마귀 날자 배 떨어진다 - Pure coincidence
나사가 빠지다 - Be absent
날개가 돋치다 - Sell like hotcakes
날벼락을 맞다 - Get hit by sudden misfortune
낯이 익다 - Look familiar
눈 깜짝할 새 - In the blink of an eye
눈빛이 다르다 - Have a sharp look
눈에 넣어도 아프지 않다 - Love dearly
눈을 붙이다 - Catch some sleep
다리를 놓다 - Bridge the gap
도끼 눈을 뜨다 - Stare fiercely
돈을 물 쓰듯 하다 - Spend money like water
등을 떠밀다 - Push someone into action
뜨거운 감자 - A hot potato
마음이 놓이다 - Feel at ease
맥이 빠지다 - Lose strength
머리를 맞대다 - Put heads together
머리를 식히다 - Clear one’s head
머리를 쓰다 - Use one’s brain
몸을 아끼지 않다 - Give one’s all
물 건너가다 - Too late to fix
물 만난 고기 - Like a fish in water
바늘구멍으로 하늘 보기 - A narrow view of the world
발목을 잡다 - Hold someone back
발을 맞추다 - Keep in step
변덕이 죽 끓듯 하다 - Be fickle
불을 보듯 뻔하다 - Crystal clear
비행기 태우다 - Praise excessively
살이 빠지다 - Lose weight drastically
손때가 묻다 - Be well
손발이 맞다 - Work in sync
손을 떼다 - Wash one’s hands of something
손에 땀을 쥐다 - Be on the edge of one’s seat
속을 태우다 - Worry sick
숨이 트이다 - Feel relieved
싼 게 비지떡 - You get what you pay for
쏜살같이 - Like an arrow
앞뒤가 꽉 막히다 - Be narrow
애를 태우다 - Be anxious
열을 올리다 - Get passionate about something
입이 귀에 걸리다 - Grin from ear to ear
자기 발등을 찍다 - Shoot oneself in the foot
정신을 차리다 - Come to one’s senses
쥐구멍이라도 찾고 싶다 - Want to crawl into a hole
천리 길도 한 걸음부터 - A journey of a thousand miles begins with a single step
칼을 갈다 - Hold a grudge, prepare for revenge
코가 비뚤어지게 마시다 - Drink oneself under the table
큰소리치다 - Talk big
토끼 같은 자식 - A precious child
팔짱을 끼고 보다 - Sit back and watch
한 배를 타다 - Be in the same boat
한 치 앞을 못 보다 - Can’t see what’s ahead
환심을 사다 - Win someone’s favor
흐지부지되다 - Fade away without conclusion
힘이 부치다 - Be beyond one’s ability
가는 날이 장날이다 - Bad timing
가슴을 울리다 - Touch one’s heart
꼬리를 내리다 - Surrender, back down
꽃길만 걷다 - Have a smooth, happy life
날개를 달다 - Gain momentum
다 된 밥에 재 뿌리다 - Spoil everything at the last minute
머리를 굴리다 - Think hard, strategize
벼락치기 하다 - Cram at the last minute
신경을 곤두세우다 - Be on edge
아는 길도 물어 가라 - Better safe than sorry
엎질러진 물 - No use crying over spilled milk
입만 살아 있다 - All talk, no action
찬밥 신세 - Be neglected, treated coldly
초를 치다 - Spoil the fun
팔짱 끼고 구경하다 - Stand by and do nothing
하늘 높은 줄 모르다 - Be arrogant
한 우물을 파다 - Stick to one thing
허탕치다 - Come up empty
호되게 혼나다 - Get scolded badly
힘에 부치다 - Be overwhelmed
기가 차다 - Be dumbfounded
오금이 저리다 - Feel nervous
속도 모르고 - Be clueless
가슴에 새기다 - Engrave in one’s heart
가슴을 쓸어내리다 - Breathe a sigh of relief
간이 떨어지다 - Get scared suddenly
갈 길이 멀다 - Have a long way to go
감투를 쓰다 - Hold an important position
값어치를 하다 - Be worth it
같은 배를 타다 - Be in the same boat
개미처럼 일하다 - Work like a horse
검은 머리 파뿌리 되도록 - Until old age
겉 다르고 속 다르다 - Two
겉만 번지르르하다 - All flash, no substance
고개를 끄덕이다 - Nod in agreement
고개를 젓다 - Shake one’s head
고양이 앞의 쥐 - Frozen in fear
골칫덩이가 되다 - Be a headache
귀를 의심하다 - Can’t believe one’s ears
귀청이 떨어지다 - Deafeningly loud
그늘이 지다 - Be overshadowed
그림자를 밟다 - Step on one’s shadow (follow closely)
금이 가다 - Relationship cracks
기를 쓰다 - Do something desperately
길을 터주다 - Pave the way
깨소금 맛이다 - Taste of revenge
내 코가 석 자다 - Have one’s own problems
눈꼽만큼도 없다 - Not even a speck
눈살을 찌푸리다 - Frown
다 된 밥에 코 빠뜨리다 - Ruin something last minute
다리를 절다 - Limp
단물을 빨다 - Take all the benefits
단물만 빨아먹다 - Exploit someone
대박이 터지다 - Hit the jackpot
도둑이 제 발 저리다 - A guilty conscience needs no accuser
독이 오르다 - Be fired up
돌을 던지다 - Accuse someone
동에 번쩍, 서에 번쩍 - Be everywhere
두 손 두 발 다 들다 - Give up completely
둘이 먹다 하나가 죽어도 모른다 - So delicious one forgets everything
뒤통수를 맞다 - Be betrayed
따 놓은 당상 - A sure thing
땅 짚고 헤엄치기 - Too easy
때를 놓치다 - Miss the timing
땀이 비 오듯 흐르다 - Sweat profusely
마음이 굴뚝같다 - Eager to do something
말꼬리를 잡다 - Nitpick words
맥이 풀리다 - Lose all energy
머리에 피도 안 마르다 - Be too young and inexperienced
먹물 좀 들었다 - Be educated
먼 산 보듯 하다 - Be indifferent
몸 둘 바를 모르다 - Feel flustered
무릎을 치다 - Have a sudden realization
물 쓰듯 하다 - Waste resources
물 불 안 가리고 - Recklessly
바닥을 기다 - Hit rock bottom
바람을 넣다 - Instigate
바람을 피우다 - Cheat on someone
바짝 긴장하다 - Be extremely nervous
반짝반짝 빛나다 - Shine brightly
발을 동동 구르다 - Be anxious
방방 뜨다 - Be overly excited
배꼽 빠지게 웃다 - Laugh uncontrollably
배보다 배꼽이 크다 - The minor cost exceeds the major one
벽을 허물다 - Break down barriers
별걸 다 신경 쓰다 - Worry about everything
보약이 되다 - Be beneficial in the long run
불티나게 팔리다 - Sell like hotcakes
비 오듯 하다 - Be drenched (in sweat or tears)
빈 수레가 요란하다 - Empty vessels make the most noise
빛을 발하다 - Shine (metaphorically)
살얼음판을 걷다 - Walk on thin ice
상다리가 부러지다 - A feast with lots of food
서류를 밟다 - Go through paperwork
선을 넘다 - Cross the line
손가락 하나 까딱 안 하다 - Do nothing at all
손바닥 뒤집듯 하다 - Change one’s mind easily
손에 잡힐 듯 하다 - Be within reach
손이 모자라다 - Be understaffed
숨 넘어갈 뻔하다 - Almost pass out
시시콜콜 따지다 - Be overly nitpicky
씨도 안 먹히다 - Not work at all
아끼다 똥 된다 - Being too frugal backfires
알다가도 모를 일 - A mystery
앞뒤 안 가리다 - Be reckless
어깨를 나란히 하다 - Stand shoulder to shoulder
얼굴이 반쪽이 되다 - Look exhausted
열 손가락 깨물어 안 아픈 손가락 없다 - Every child is precious to a parent
옷이 날개다 - Clothes make the man
우물 안 개구리 - A frog in a well
울고 싶은데 뺨 맞다 - Be pushed to tears
으름장을 놓다 - Threaten
입에 침이 마르다 - Praise endlessly
자리를 박차고 나가다 - Storm out
작심삼일 - A short
장난이 아니다 - Not a joke, serious
쪽팔리다 - Be embarrassed
천둥벌거숭이 같다 - Act recklessly
첫 단추를 잘못 끼우다 - Start off on the wrong foot
침이 마르다 - Talk non
칼을 빼 들다 - Take drastic action
코웃음을 치다 - Scoff at something
콧방귀를 뀌다 - Snort in disbelief
큰일 났다 - Be in big trouble
택도 없다 - Not a chance
팔짱을 끼다 - Fold one’s arms (indifference)
피도 눈물도 없다 - Be heartless
피를 나누다 - Be blood
한 귀로 듣고 한 귀로 흘리다 - In one ear and out the other
한 술 더 뜨다 - Make things worse
함흥차사 - No news from someone
허리가 휘다 - Be overwhelmed (by work or expenses)
허둥지둥하다 - Rush in a panic
허리가 휠 정도로 일하다 - Work one’s fingers to the bone
헛다리를 짚다 - Bark up the wrong tree
호락호락하지 않다 - Not be easy to deal with
호리병 속의 용 - A hidden genius
화를 돋우다 - Provoke someone
후회막급 - Too late for regrets
흥청망청 - Spend or waste recklessly
가슴이 벅차다 - Be overwhelmed with emotion
거품을 물다 - Get overly angry
계란으로 바위 치기 - A futile effort
고래 싸움에 새우 등 터진다 - Caught in the crossfire
곡소리가 나다 - Be in deep trouble
구설수에 오르다 - Be the subject of gossip
귀가 가렵다 - Someone is talking about you
귀에 거슬리다 - Sound unpleasant
기고만장하다 - Be on top of the world
길눈이 어둡다 - Have no sense of direction
김이 새다 - Lose enthusiasm
날개를 펴다 - Spread one’s wings
날카로운 눈빛 - A sharp gaze
남의 떡이 커 보인다 - The grass is always greener
눈 깜짝할 사이에 - In a flash
눈꼬리를 올리다 - Give a sharp glare
눈독을 들이다 - Have one’s eye on something
눈썹 하나 까딱하지 않다 - Not bat an eye
눈이 뚫어지게 보다 - Stare intently
눈이 트이다 - Gain new insight
다리 밑에서 주워 왔다 - Be adopted (as a joke)
달밤에 체조하다 - Do something in vain
닭살 돋다 - Get goosebumps
대들보가 기둥을 탓한다 - Blame others for one’s own faults
덜미를 잡히다 - Get caught red
도랑 치고 가재 잡는다 - Kill two birds with one stone
동고동락하다 - Go through thick and thin together
되로 주고 말로 받는다 - Get back much worse than one gave
등을 밀다 - Push someone forward
뜬구름 잡다 - Chase unrealistic dreams
마각을 드러내다 - Reveal one’s true colors
마이동풍 - Fall on deaf ears
말꼬리를 잡고 늘어지다 - Nitpick someone’s words
맥 빠지다 - Lose motivation
머리를 싸매다 - Rack one’s brains
목구멍이 포도청 - Need to work to survive
몸이 근질거리다 - Itching to do something
바람 앞의 등불 - A precarious situation
방방 뛰다 - Get overly excited
배꼽이 빠지다 - Laugh uncontrollably
벼락 맞을 소리 - An outrageous statement
보따리를 싸다 - Pack up and leave
빈말을 하다 - Make empty promises
빛 좋은 개살구 - Looks good but isn’t
살이 찌다 - Gain weight (literally & figuratively)
선무당이 사람 잡는다 - A little knowledge is dangerous
설마가 사람 잡는다 - Complacency leads to disaster
성에 차다 - Be satisfied
소 닭 보듯 하다 - Be indifferent
소문난 잔치에 먹을 것 없다 - Overhyped but disappointing
손에 쥐가 나다 - Have a cramp
손에 물 한 방울 안 묻히다 - Live a pampered life
속을 끓이다 - Worry oneself sick
속이 풀리다 - Feel relieved
술이 웬수다 - Alcohol causes trouble
아귀가 맞다 - Fit together perfectly
악에 받치다 - Be filled with rage
앞뒤가 막히다 - Be narrow
엎어지면 코 닿을 거리 - A stone’s throw away
어깨가 무겁다 - Carry a heavy burden
어안이 벙벙하다 - Be dumbfounded
엿장수 마음대로 - Do as one pleases
오리발을 내밀다 - Play dumb
옥에 티 - A flaw in perfection
올가미를 씌우다 - Trap someone
와신상담 - Endure hardship for revenge
외나무다리에서 만나다 - Face one’s enemy inescapably
용두사미 - A strong start but weak finish
우물에 가서 숭늉 찾는다 - Be impatient
웃는 얼굴에 침 못 뱉는다 - Kindness disarms hostility
울고 보채다 - Complain and nag
원숭이도 나무에서 떨어진다 - Even experts make mistakes
이를 악물다 - Grit one’s teeth
입에 달고 살다 - Say something repeatedly
입이 가볍다 - Be talkative (can't keep secrets)
자리를 잡다 - Settle down
자화자찬 - Self
잡아먹을 듯 하다 - Look extremely angry
죽을 쑤다 - Fail miserably
쥐도 새도 모르게 - Without anyone noticing
진땀을 빼다 - Sweat nervously
천리를 간다 - Travel a long distance
철석같이 믿다 - Believe something firmly
첫 단추를 잘 끼우다 - Start off on the right foot
침을 뱉다 - Spit in disgust
코가 삐뚤어지게 마시다 - Drink excessively
턱걸이를 하다 - Barely pass or succeed
팔자가 사납다 - Be unlucky
피 터지게 싸우다 - Fight fiercely
핏줄을 타고나다 - Inherit traits
하늘을 찌를 듯하다 - Reach high ambitions
함정을 파다 - Set a trap
허리를 펴다 - Relax after hardship
허탕을 치다 - End up empty
화들짝 놀라다 - Be startled
후환이 두렵다 - Fear future consequences
힘이 솟다 - Feel energized
가지 많은 나무에 바람 잘 날 없다 - Parents with many kids always have concerns
감언이설 - Sweet talk or flattery
거미줄 치다 - Be abandoned or empty
거시기하다 - Be ambiguous or awkward
걱정이 태산이다 - Be extremely worried
겨를이 없다 - Have no time to spare
결판을 내다 - Settle once and for all
고군분투하다 - Struggle alone
골머리를 앓다 - Be deeply worried
곱게 자라다 - Grow up well
공든 탑이 무너지랴 - Hard work pays off
귓등으로 듣다 - Ignore what someone says
긁어 부스럼 만들다 - Make things worse
기를 펴다 - Hold one’s head high
길을 잃다 - Lose one’s way
날개 돋친 듯 팔리다 - Sell like hotcakes
남의 잔치에 감 놓아라 배 놓아라 한다 - Interfere in others’ business
내로남불 - Hypocrisy (double standards)
노발대발하다 - Get extremely angry
눈이 높다 - Have high standards
눈치가 빠르다 - Be quick
다 된 죽에 코 빠뜨리다 - Ruin things at the last moment
달면 삼키고 쓰면 뱉는다 - Use and discard people
닭 쫓던 개 지붕 쳐다본다 - Be left helpless
동상이몽 - Same situation, different dreams
뒤끝이 있다 - Hold a grudge
뚝 떨어지다 - Drop suddenly
마음이 콩밭에 가 있다 - Be distracted
말 한 마디로 천 냥 빚 갚는다 - Words have power
바늘 도둑이 소도둑 된다 - Small crimes lead to bigger ones
배가 아프다 - Be jealous
백지장도 맞들면 낫다 - Cooperation makes things easier
빈 깡통이 요란하다 - Empty vessels make the most noise
호랑이에게 물려가도 정신만 차리면 산다 - Stay calm in a crisis
가슴이 철렁하다 - Feel one’s heart sink
각광을 받다 - Be in the spotlight
감쪽같다 - Look completely natural (as if nothing happened)
골치가 아프다 - Have a headache (due to a problem)
꼬리를 물다 - Events happen in succession
내 알 바 아니다 - Not my business
넋을 놓다 - Zone out
눈이 뒤집히다 - Lose control out of anger or greed
달아오르다 - Get heated (literally or emotionally)
대문을 열다 - Open one’s heart (or house for guests)
두 다리 쭉 뻗고 자다 - Sleep peacefully
마음이 풀리다 - Feel relieved or forgive someone
말꼬리를 물다 - Nitpick someone’s words
물불을 가리지 않다 - Stop at nothing
발이 묶이다 - Be stuck (unable to move or act)
번갯불에 콩 볶아 먹듯 - Do something hastily
복장이 터지다 - Feel extremely frustrated
볼멘소리를 하다 - Complain in a sulky manner
사족을 못 쓰다 - Be obsessed with something
색안경을 끼고 보다 - See with bias
서슬이 퍼렇다 - Be extremely intimidating
성질을 죽이다 - Suppress one’s temper
손이 발이 되도록 빌다 - Beg desperately
씨가 마르다 - Become extremely scarce
앞뒤를 재다 - Weigh the pros and cons
애가 타다 - Be anxious or worried
어깨를 들썩이다 - Shake one’s shoulders (crying or laughing)
엎지른 물 - Something irreversible
우는 소리를 하다 - Complain about hardship
웃을 날이 오다 - Good days finally arrive
유리창에 금 가듯 - A fragile relationship
이마에 주름이 잡히다 - Worry deeply
입이 닳도록 말하다 - Say something over and over
자리를 뜨다 - Leave a place
장단을 맞추다 - Play along with someone
제 눈에 안경 - Beauty is in the eye of the beholder
주머니가 가볍다 - Be broke
줄행랑을 놓다 - Run away
지붕을 뚫다 - Be extremely energetic or excited
짚신도 제짝이 있다 - Everyone has their match
쪽박을 차다 - Go completely broke
책을 덮다 - Stop discussing a matter
천리길도 한 걸음부터 - A journey starts with a single step
철이 들다 - Become mature
첫 발을 내딛다 - Take the first step
청천벽력 - A bolt from the blue (shocking news)
타산지석 - Learn from others' mistakes
태산을 넘다 - Overcome a huge obstacle
토를 달다 - Keep making excuses
판을 깨다 - Ruin an agreement
팔짱을 끼고 구경하다 - Stand by and do nothing
피가 거꾸로 솟다 - Get extremely angry
피눈물을 흘리다 - Suffer deeply
하늘이 두 쪽 나도 - No matter what happens
가는 말이 고와야 오는 말이 곱다 - Treat others well to be treated well
가랑비에 옷 젖는 줄 모른다 - Small things add up
가재는 게 편 - Like attracts like
간에 기별도 안 간다 - Not enough to satisfy (food)
갈팡질팡하다 - Waver between choices
개가 웃을 일이다 - Ridiculous beyond belief
개구리 올챙이 적 생각 못 한다 - Forget one's humble beginnings
개똥도 약에 쓰려면 없다 - Hard to find when needed
객쩍은 소리를 하다 - Say something foolish
거덜 나다 - Go bankrupt
거울을 보다 - Reflect on oneself
건수를 잡다 - Catch an opportunity
걸음아 날 살려라 - Run for one’s life
검은 속을 드러내다 - Reveal one’s true (bad) intentions
겉멋 들다 - Care only about appearances
공을 들이다 - Put great effort into something
광분하다 - Go crazy with excitement or anger
굴뚝같다 - Want something badly
귀가 번쩍 뜨이다 - Be all ears (attractive news)
귀신같이 알아맞히다 - Guess something accurately
귓가에 맴돌다 - Keep hearing something
기사회생하다 - Revive at the last moment
김이 빠지다 - Lose excitement
꼬리를 감추다 - Disappear without a trace
나무를 보고 숲을 보지 못하다 - Miss the big picture
나사가 풀리다 - Lose focus or control
낯을 가리다 - Be shy around strangers
내 코가 석 자 - Be too busy with one’s own problems
냉수를 끼얹다 - Spoil the mood
달걀로 바위 치기 - A hopeless attempt
도깨비 방망이 - A magical solution
동네북 - Someone who gets blamed by everyone
두 손을 들다 - Completely surrender
막상막하 - Neck
맥을 못 추다 - Be powerless
머리를 쥐어짜다 - Think hard
머리가 비다 - Be foolish
먼지를 털다 - Get rid of bad habits
목을 축이다 - Quench one’s thirst
못을 박다 - Say something decisive
물과 기름 - Completely different things
물거품이 되다 - End in failure
바닥이 나다 - Run out of something
발을 빼다 - Withdraw from a situation
밤낮이 없다 - Work tirelessly
배째라 - Be completely uncooperative
백기를 들다 - Surrender
벼락치기 - Last
본전을 찾다 - Break even
불똥이 튀다 - Unexpected trouble spreads
비 오듯 땀을 흘리다 - Sweat profusely
사공이 많으면 배가 산으로 간다 - Too many cooks spoil the broth
삼십육계를 놓다 - Run away tactfully
서두에 쓴 약은 입에 쓰다 - Good advice is hard to swallow
선수를 치다 - Take action before others
소가 뒷걸음질 치다가 쥐 잡는다 - A lucky coincidence
소 닭 보듯 - Show indifference
손에 잡힐 듯하다 - Be within reach
손이 크다 - Be generous
아등바등 살다 - Struggle desperately
아랫물이 맑아야 윗물이 맑다 - Good leadership produces good followers
안 봐도 뻔하다 - Be obvious without seeing
앞뒤가 맞지 않다 - Be inconsistent
앞길이 구만리 같다 - Have a long future ahead
애가 끓다 - Be extremely anxious
어깨춤이 절로 나다 - Feel excited and happy
얼굴에 철판을 깔다 - Be shameless
오리무중이다 - Be lost in confusion
오십보백보 - Almost the same (small difference)
우왕좌왕하다 - Be confused and disorganized
울고 싶은데 뺨 때려 준다 - A small push leads to an outburst
웃는 낯에 침 못 뱉는다 - Hard to be rude to a kind person
입만 살다 - Talk big but not act
입을 맞추다 - Coordinate stories (or kiss)
자다가 봉창 두드린다 - Say something irrelevant
자리를 박차고 일어나다 - Get up angrily
자린고비처럼 살다 - Live extremely frugally
잔뼈가 굵다 - Be very experienced
잔머리를 굴리다 - Try to be cunning
잠자는 사자의 코털을 건드리다 - Poke the bear
장에 가서 김치 사온다 - State the obvious
재를 뿌리다 - Spoil the mood
적반하장이다 - The guilty act as the innocent
전광석화처럼 - As fast as lightning
절반의 성공 - A partial success
점수를 따다 - Earn favor
정신이 나가다 - Lose one’s mind
정이 들다 - Grow attached
제 코가 석 자다 - Have too many problems to help others
죽이 맞다 - Click well with someone
쥐구멍에도 볕 들 날이 있다 - Even bad situations improve
지름길을 찾다 - Find a shortcut
진을 빼다 - Drain one’s energy
채를 쳐서 걸러내다 - Filter out unnecessary things
천근만근이다 - Feel extremely heavy (physically or emotionally)
청천벽력이다 - A bolt from the blue
촌철살인의 말 - A short but powerful statement
총대를 메다 - Take responsibility
코앞에 닥치다 - Be imminent
콩 심은 데 콩 나고 팥 심은 데 팥 난다 - You reap what you sow
타산지석으로 삼다 - Learn from others’ mistakes
트집을 잡다 - Nitpick
팥으로 메주를 쑨다 해도 믿는다 - Believe anything, no matter how ridiculous
함흥차사다 - Disappear without a trace
혼쭐이 나다 - Get scolded severely
화가 머리끝까지 나다 - Be absolutely furious
후회막급이다 - Regret deeply with no way to fix it
닭 쫓던 개 지붕 쳐다보듯 - Feel helpless after failing
두 마리 토끼를 잡다 - Achieve two goals at once
등이 휘다 - Be overworked
떡 줄 사람은 생각도 않는데 김칫국부터 마신다 - Assume success too soon
마음을 비우다 - Let go of greed or attachment
마이동풍이다 - Advice falls on deaf ears
막차를 타다 - Barely make it in time
머리가 굳다 - Be slow
목숨을 걸다 - Risk one’s life
몸을 사리다 - Avoid danger or responsibility
바람을 맞다 - Be stood up
방귀 뀐 놈이 성낸다 - A guilty person acts offended
배가 등에 붙다 - Be extremely hungry
배를 불리다 - Gain personal benefits unfairly
비 온 뒤 땅이 굳어진다 - Hardships make one stronger
산 넘어 산이다 - One problem after another
세월을 낚다 - Waste time idly
속이 터지다 - Feel extreme frustration
손을 씻다 - Stop doing something (especially bad habits)
손을 잡다 - Cooperate
신물이 나다 - Be fed up with something
어깨를 으쓱거리다 - Feel proud
얼굴을 들다 - Feel confident가슴을 쓸어내리다
눈이 맞다 - Fall in love
마음을 잡다 - Pull oneself together
말을 돌리다 - Change the subject
바가지를 쓰다 - Be ripped off
허리를 굽히다 - Bow in humility
가슴이 찢어지다 - Be heartbroken
골치를 앓다 - Have a headache (be troubled)
눈에서 불이 나다 - Be extremely angry or in pain
눈코 뜰 새 없다 - Be extremely busy
뒤가 구리다 - Have something to hide
바늘 가는 데 실 간다 - Be inseparable (go hand in hand)
발목을 잡히다 - Be held back by something
뼈를 묻다 - Devote one’s life to something
얼굴에 먹칠하다 - Disgrace oneself or one’s family
천리를 가도 변하지 않는다 - Stay constant no matter what
피땀을 흘리다 - Sweat blood (work extremely hard)
하늘을 찌르다 - Be sky
개미 새끼 한 마리 없다 - No one in sight (completely empty)
구미가 당기다 - Be tempted or interested
김칫국부터 마시다 - Count one’s chickens before they hatch
눈 하나 깜짝하지 않다 - Stay calm under pressure
마른하늘에 날벼락 - A sudden misfortune (like a bolt from the blue)
모래 위에 물 쏟기 - A futile effort
목에 힘을 주다 - Act arrogantly
목이 빠지게 기다리다 - Wait anxiously (like a long
밑 빠진 독에 물 붓기 - A wasted effort (like pouring water into a bottomless jar)
배 째라 - Refuse to yield (literally 'cut my stomach open')
병 주고 약 주다 - Hurt someone and then pretend to help
서당 개 삼 년이면 풍월을 읊는다 - Practice makes perfect
소귀에 경 읽기 - Talking to a brick wall
걷기도 전에 뛰려고 한다 - Trying to run before learning to walk
고슴도치도 제 새끼는 예쁘다고 한다 - Even a hedgehog finds its baby cute
구슬이 서 말이라도 꿰어야 보배 - Effort is needed to make something valuable
꿩 먹고 알 먹기 - Kill two birds with one stone
낙숫물이 바위를 뚫는다 - Persistence pays off
냉수 먹고 이 쑤신다 - Pretending to have more than one does
누워서 침 뱉기 - Self
다 된 밥에 재 뿌리기 - Ruin something at the last moment
닭 잡아먹고 오리발 내민다 - Feign innocence after wrongdoing
모로 가도 서울만 가면 된다 - The end justifies the means
바늘 도둑이 소 도둑 된다 - Small crimes lead to bigger ones
세 살 버릇 여든까지 간다 - Old habits die hard
수박 겉 핥기 - Superficial understanding
아닌 밤중에 홍두깨 - Something unexpected happens suddenly
열 번 찍어 안 넘어가는 나무 없다 - Persistence leads to success
오르지 못할 나무는 쳐다보지도 마라 - Don’t aim for the impossible
자라 보고 놀란 가슴 솥뚜껑 보고 놀란다 - Once bitten, twice shy
재주는 곰이 부리고 돈은 왕서방이 번다 - One works hard, another reaps the benefits
찬밥 더운밥 가릴 처지가 아니다 - Can’t afford to be picky
하룻강아지 범 무서운 줄 모른다 - Ignorance is fearless
하늘이 무너져도 솟아날 구멍은 있다 - There’s always a way out
공짜라면 양잿물도 마신다 - People will take anything if it’s free
가재는 게 편이다 - Similar people protect each other
친구 따라 강남 간다 - Following others blindly
가는 날이 장날 - Bad timing
가시방석에 앉은 듯 - Feeling extremely uncomfortable
갈수록 태산 - Things keep getting harder
개미 구멍이 둑을 무너뜨린다 - Small mistakes cause big problems
고양이에게 생선을 맡기다 - Letting the fox guard the henhouse
길고 짧은 것은 대봐야 안다 - You don’t know the result until you compare
까마귀 고기를 먹었나? - Being forgetful
남의 떡이 더 커 보인다 - The grass is always greener on the other side
도둑을 잡으려면 도둑처럼 생각하라 - Think like the enemy
떡 줄 사람은 꿈도 안 꾸는데 김칫국부터 마신다 - Getting ahead of yourself
말은 해야 맛이고, 떡은 씹어야 맛이다 - Things must be done properly to be effective
벽에 귀가 있다 - Someone might be listening
불난 집에 부채질 - Making a bad situation worse
사촌이 땅을 사면 배가 아프다 - Being jealous of others' success
서울에서 김서방 찾기 - Looking for a needle in a haystack
소 잃고 외양간 고친다 - Fixing things too late
시작이 반이다 - Well begun is half done
심사숙고하다 - Think deeply before deciding
어물쩍 넘어가다 - Avoid a topic without solving it
열 길 물속은 알아도 한 길 사람 속은 모른다 - It’s hard to know a person’s true intentions
윗물이 맑아야 아랫물이 맑다 - Leaders set the example
호박이 넝쿨째 굴러들어오다 - Luck falls into one’s lap
화장실 갈 때 마음 다르고 나올 때 마음 다르다 - People change their minds after getting what they want
황소 뒷걸음질 치다가 쥐 잡는다 - A lucky accident
가는 정이 있어야 오는 정이 있다 - Give and take
초록은 동색 - Birds of a feather flock together
거미도 줄을 쳐야 벌레를 잡는다 - Preparation is key
말 한마디에 천 냥 빚도 갚는다 - Words have power
가슴이 내려앉다 - Be extremely shocked or scared
고삐를 죄다 - Tighten control
까놓고 말하다 - Speak openly and honestly
날을 잡다 - Set a date for an event
눈에 밟히다 - Keep thinking about something or someone
눈에 익다 - Look familiar
눈에서 멀어지면 마음에서도 멀어진다 - Out of sight, out of mind
도끼자루 썩는 줄 모른다 - Be so focused that time flies
뒤끝이 없다 - Not hold grudges
뜬구름을 잡다 - Chase unrealistic dreams
바가지를 긁다 - Nag (often referring to a wife nagging a husband)
발 뻗고 자다 - Sleep peacefully without worries
뼈 빠지게 일하다 - Work extremely hard
숨이 턱에 차다 - Be out of breath
어깨가 으쓱하다 - Feel proud
입을 모으다 - People agree on something
가는 귀가 먹다 - Pretend not to hear
가슴이 미어지다 - Feel heartbroken
개처럼 벌어서 정승처럼 쓴다 - Work hard and spend wisely
고슴도치도 제 새끼는 예쁘다 - Even a hedgehog finds its baby cute
공중에 뜨다 - Be in an unstable situation
기를 죽이다 - Discourage someone
넋이 나가다 - Be out of it (shocked, dazed, or absent
눈 감아 주다 - Turn a blind eye
눈꼴이 시다 - Find something annoying to look at
닭살이 돋다 - Get goosebumps
동에 번쩍 서에 번쩍 - Appear and disappear quickly
등골이 휜다 - Struggle financially or work extremely hard
목을 메다 - Be choked up with emotion
물 불 안 가리다 - Do anything regardless of risk
바늘방석에 앉다 - Feel extreme discomfort in a situation
방방곡곡 - Everywhere, all over the place
손가락질하다 - Point fingers at someone (criticize or blame)
손에 익다 - Get used to something
악어의 눈물 - Crocodile tears (fake sadness)
애를 쓰다 - Make an effort
엎친 데 덮친 격 - When it rains, it pours (one problem after another)
요지부동 - Completely unmovable or stubborn
우왕좌왕 - Be confused and disorganized
입 밖에 내다 - Say something out loud (usually a secret)
입에 거미줄 치다 - Be extremely poor (literally, ‘a spider’s web in the mouth’)
입이 딱 벌어지다 - Be amazed or shocked
자기 무덤을 파다 - Dig one’s own grave
잔뜩 벼르다 - Be determined and ready for something
전광석화 같다 - Be as fast as lightning
제 발등을 찍다 - Bring misfortune upon oneself
지렁이도 밟으면 꿈틀한다 - Even the weakest will fight back when cornered
참새가 방앗간을 그냥 지나치랴 - Unable to resist temptation
천릿길도 한 걸음부터 - A journey of a thousand miles begins with a single step
코 묻은 돈 - Money from small children
티격태격하다 - Bicker or argue
한술 더 뜨다 - Make a situation even worse
호리병 속의 좁은 길 - A very difficult path
화끈화끈하다 - Feel embarrassed or very hot
후한 인심 - Generous hospitality
휘둘리다 - Be swayed or influenced
흉내도 내기 어렵다 - Too difficult to imitate
힘을 모으다 - Join forces or unite efforts
가슴이 뭉클하다 - Be deeply moved emotionally
간에 기별도 안 가다 - Too little food to feel satisfied
개 발에 편자 - Something that doesn’t suit someone
고개가 숙여지다 - Feel admiration or respect
구색을 맞추다 - Ensure variety or balance
귀가 따갑다 - Be tired of hearing something repeatedly
귀를 기울이다 - Listen carefully
날을 세우다 - Be sharp or aggressive in speech
남의 다리 긁다 - Do something useless or unrelated
눈 하나 깜짝 안 하다 - Stay calm in any situation
말꼬리를 물고 늘어지다 - Nitpick someone’s words
발을 구르다 - Be anxious or frustrated
발을 들여놓다 - Get involved in something
바닥을 치다 - Hit rock bottom
눈을 의심하다 - Can’t believe one’s eyes
혀를 차다 - Click one’s tongue (in disapproval or pity)
쥐구멍에도 볕들 날 있다 - Everyone has a lucky day
뒷짐을 지다 - Stand by and watch without taking action
어깨를 펴다 - Straighten one’s shoulders (gain confidence)
머리를 스치다 - An idea suddenly comes to mind
눈을 뗄 수 없다 - Can’t take one’s eyes off something
한 발 늦다 - Be one step too late
떡 본 김에 제사 지낸다 - Take advantage of a situation
밥 먹듯이 하다 - Do something habitually (usually negative)
판을 뒤집다 - Flip the situation around completely
애간장이 녹다 - Feel extreme anxiety or worry
다리 뻗고 자다 - Sleep peacefully without worries
허튼소리를 하다 - Talk nonsense
말문이 막히다 - Be at a loss for words
발등을 찍다 - Regret helping someone who betrayed you
손사래를 치다 - Gesture ‘no’ with one’s hands
죽기 살기로 하다 - Give it one’s all (as if life depends on it)
하나를 보면 열을 안다 - Understand the whole from a small part가는 말이 고와야 오는 말이 곱다
뛰는 놈 위에 나는 놈 있다 - There's always someone better.
값싼 것이 비지떡 - You get what you pay for.
과부 사정은 홀아비가 안다 - Only those in the same situation understand each other.
낯 가죽이 두껍다 - Shameless.
다람쥐 쳇바퀴 돌 듯 - Running in circles.
모르면 약, 아는 게 병 - Ignorance is bliss.
믿는 도끼에 발등 찍힌다 - Betrayed by someone trusted.
벼룩의 간을 내먹는다 - Exploiting the weak.
손바닥으로 하늘 가리기 - Denying the obvious.
쇠귀에 경 읽기 - Talking to a brick wall.
안 되면 조상 탓 - Blaming others for one’s failure.
자라 보고 놀란 가슴, 솥뚜껑 보고 놀란다 - Once bitten, twice shy.
천 리 길도 한 걸음부터 - A journey of a thousand miles begins with a single step.
칼로 물 베기 - A fight that won’t last.
하늘의 별 따기 - Almost impossible.
한 귀로 듣고 한 귀로 흘린다 - In one ear, out the other.
한 치 앞을 못 본다 - Short
흥정은 붙이고 싸움은 말려라 - Encourage deals, discourage fights.
거미 줄에 새 걸린다 - The unexpected happens.
등잔 밑이 어둡다 - The closest things are hardest to see.
냉수 먹고 이 쑤시기 - Pretending to have something one doesn’t.
물에 빠지면 지푸라기라도 잡는다 - Clutching at straws.
소가 뒷걸음질 치다 쥐 잡는다 - Success by pure luck.
닭 잡아먹고 오리발 내밀기 - Playing innocent after doing wrong.
목마른 사람이 우물 판다 - The one in need takes action.
찬물도 위아래가 있다 - Respect hierarchy.
제 눈의 들보는 못 보고 남의 티끌만 본다 - See others' faults, not one's own.
길고 짧은 건 대봐야 안다 - You never know until you try.
남의 말 하기는 쉽다 - Easy to criticize others.
꼬리가 길면 밟힌다 - Lies get caught.
길이 아니면 가지 말라 - Stay on the right path.
강 건너 불구경 - Watching a fire across the river (indifferent attitude).
강물도 쓰면 준다 - Even abundant resources can be depleted.
고양이 목에 방울 달기 - A good idea, but impossible to execute.
고양이 손을 빌리다 - So busy that even a cat’s help is needed.
구관이 명관이다 - The old is better than the new.
나무를 보고 숲을 보지 못한다 - Missing the forest for the trees.
눈 감으면 코 베어 간다 - Be cautious, or you’ll be deceived.
돼지 목에 진주 목걸이 - Pearls before swine.
말 타면 경마 잡히고 싶다 - People always want more.
물 위에 기름 - Two things that don’t mix.
물이 깊어야 고기가 모인다 - True talent gathers in deep waters.
물이 없으면 배가 못 간다 - No progress without a foundation.
물에 빠진 놈 건져 놓으니 보따리 내놓으라 한다 - Helping an ungrateful person.
미꾸라지 한 마리가 온 물을 흐린다 - One bad apple spoils the bunch.
벼룩도 낯짝이 있다 - Even the smallest creatures have dignity.
봄날의 개 - Carefree and happy.
산 입에 거미줄 치랴 - No one starves to death easily.
쏘아 놓은 화살 - Something irreversible.
아니 땐 굴뚝에 연기 날까? - No smoke without fire.
알 까는 닭 쳐다보듯 - Watching anxiously.
양의 탈을 쓴 늑대 - A wolf in sheep’s clothing.
어물전 망신은 꼴뚜기가 시킨다 - One person ruins the reputation of a group.
열길 물속은 알아도 한 길 사람 속은 모른다 - People’s hearts are unknowable.
오이 밭에서 신발 끈 고쳐 매지 마라 - Avoid suspicious actions.
일석이조 - Killing two birds with one stone.
장님 코끼리 만지기 - A partial view of the whole.
천둥 번개에 개도 놀란다 - Anyone can be startled.
호랑이를 잡으려면 호랑이 굴에 들어가야 한다 - No risk, no reward.
흐린 물에 고기 안 낚인다 - Things must be clear for success.
흙 속에서 진주를 줍다 - Finding a gem in the dirt.
양두구육 - A deceptive appearance.
가까운 무당보다 먼 데 무당이 영하다 - The grass is always greener on the other side.
가지 많은 나무 바람 잘 날 없다 - A person with many responsibilities always has trouble.
강한 자가 살아남는 것이 아니라 살아남는 자가 강한 것이다 - Survival is the ultimate strength.
높은 곳에 올라가려면 낮은 곳에서부터 시작해야 한다 - Start from the bottom.
늦게 배운 도둑이 날 새는 줄 모른다 - A late learner becomes overly enthusiastic.
다리 떨면 복 나간다 - Shaking your legs is a sign of carelessness.
독 안에 든 쥐 - A trapped situation.
동네방네 떠들다 - Spreading news everywhere.
묵은 밥이 맛있다 - Experience brings quality.
물 들어올 때 노 젓는다 - Strike while the iron is hot.
미운 놈 떡 하나 더 준다 - Kill them with kindness.
부뚜막의 소금도 집어넣어야 짜다 - Even simple tasks require effort.
술은 마셨지만 음주운전은 안 했다 - Making excuses.
자만하면 반드시 실패한다 - Pride comes before a fall.
좋은 약은 입에 쓰다 - The truth hurts.
힘든 일일수록 끝까지 해내라 - The harder the task, the greater the reward.
금도끼 은도끼 - Not appreciating what you have until it’s gone.
기름진 밥에 고기가 없다 - Money doesn’t come easily.
돈이 돌고 돌다 - Money circulates and comes back.
돈 한 푼 아끼려다가 큰 손해 본다 - Cutting corners can lead to bigger losses.
돈 없어도 사람은 사람이다 - A person’s worth isn’t determined by money.
돈이 어디서 나오나 - Wondering where the money comes from.
돈이 최고다 - Money is everything.
돈이란 속물에게만 가치가 있다 - Money is valuable to materialistic people.
돈이 돈을 낳는다 - Money breeds more money.
돈을 주고도 못 얻을 것 - Something unreachable, even with money.
돈을 벌다 - To earn money.
돈을 물 쓰듯 쓰다 - To spend money recklessly.
돈을 잃는 것보다 더 큰 손해는 없다 - Losing money is the biggest loss.
돈을 세는 손가락이 아프다 - A situation where money is flowing out quickly.
돈을 쥐어도 한두 푼 - Even if you hold on to money, it's still just a small amount.
돈은 나가면 나갈수록 돌아온다 - The more you invest, the greater the return.
돈을 위해서는 살인도 한다 - Some people will do anything for money.
돈을 찾으면 욕심이 생긴다 - Greed arises when you have money.
돈은 써도 써도 끝이 없다 - Money seems to disappear no matter how much you spend.
돈을 위해서라면 가는 곳은 어디든지 - People will go anywhere for money.
돈을 벌어놓고 아끼는 것도 아깝다 - Saving money isn’t worth it if you’re not enjoying it.
돈이 최고라면 도덕이 중요하지 않다 - Morality doesn’t matter if money is the top priority.
돈이 없어도 할 수 있다 - You can do things even without money.
돈이 많다고 행복한 것은 아니다 - Money doesn’t guarantee happiness.
돈이 없어도 사람은 살아간다 - People can survive without money.
돈이 있으면 일을 시킬 수 있다 - Money gives power to command others.
돈을 아껴서 쓸 때가 좋다 - Saving money can be better in the long run.
돈을 쓰는 것이 쌓이는 것보다 낫다 - It’s better to spend money than accumulate it endlessly.
돈이 없으면 사람도 없다 - Without money, you have no friends.
돈은 빚을 갚는 데 쓴다 - Money is used to pay debts.
돈이 많다고 행복이 오는 것은 아니다 - Having a lot of money doesn’t bring happiness.
돈이 많아도 그릇이 작은 사람 - Someone with money but no depth.
돈에 눈이 멀다 - Being blinded by money.
돈을 더 벌고 싶어 한다 - Wanting to make more money.
돈을 대면 무섭다 - People act differently when money is involved.
돈을 던져주면 다 웃는다 - Money makes everyone happy.
돈을 벌기 위해서는 먼저 땀을 흘려야 한다 - You must work hard to earn money.
돈이 많으면 뭐 하나 - What’s the use of money if you don’t have a good heart?
돈의 흐름을 읽다 - To understand the flow of money.
돈은 다신 돌아오지 않는다 - Money lost is never regained.
돈을 벌고 싶으면 먼저 주는 것이 중요하다 - It’s important to give first to make money.
돈을 위해서라면 원수를 용서한다 - People forgive their enemies for money.
돈이 있어도 친구는 아니다 - Even with money, people may not be your true friend.
돈을 흘리듯 쓴다 - Spending money carelessly.
돈을 쌓아두면 그만큼 많은 책임이 따른다 - With great wealth comes great responsibility.
돈을 쥐어주면 다 된다고 생각한다 - Thinking money solves everything.
돈이 필요하다면 무엇이든 해야 한다 - If you need money, you’ll do anything.
돈을 다 쓰고 나서 후회한다 - Regretting spending money impulsively.
돈만 있으면 뭐든 할 수 있다 - With money, you can do anything.
돈으로 해결할 수 없는 문제는 없다 - Money can solve all problems.
돈으로 사람을 사지 말라 - Don’t try to buy people.
돈은 쏟아내야 들어온다 - You must spend to make money.
돈을 쏟아 부은 대가 - The result of investing money.
돈이 많으면 마음도 넓어진다 - Money makes people more generous.
돈을 아끼려다 시간과 노력까지 아끼다 - Saving money by cutting time and effort can backfire.
돈이 목이다 - Money is the ultimate goal.
돈만 보면 눈이 돌아간다 - People become obsessed with money.
돈 없이도 행복할 수 있다 - You can be happy without money.
돈을 모은다고 삶의 질이 높아지지 않는다 - Saving money doesn’t guarantee a better life.
돈을 위해서 일하는 것은 나쁜 일이다 - Working just for money is not ideal.
돈으로 사람을 사지 않는다 - Money can’t buy people’s respect.
돈이 없어도 희망은 있다 - Even without money, there is hope.
돈이 많으면 안 된다 - Having too much money can cause problems.
돈을 갚다 - To pay back a debt.
돈을 많이 벌려면 실력을 키워라 - Build your skills to earn more money.
돈으로 행복을 살 수 없다 - You can’t buy happiness with money.
돈은 쓸수록 가치가 있다 - Money is most valuable when it’s used properly.
돈을 아껴 쓰는 것이 중요하다 - It’s important to save money wisely.
돈은 가는 곳에 늘 끌려간다 - Money always follows where there is a need.
돈을 빌리면 빚을 갚아야 한다 - If you borrow, you must repay.
돈은 금이 아니다 - Money isn’t everything.
돈을 팔아서도 아깝다 - Even selling something precious for money is not worth it.
돈을 걷는 일도 쉽지 않다 - Earning money is not easy.
돈을 아끼면 행복이 온다 - Saving money brings happiness.
돈을 벌려면 먼저 일해야 한다 - You must work first to earn money.
돈은 바람처럼 지나간다 - Money comes and goes like the wind.
돈은 적게 쓰고 많이 벌어라 - Spend less, earn more.
돈을 주면 물어온다 - People act differently when money is involved.
돈을 써도 써도 부족하다 - No matter how much you spend, it’s never enough.
돈을 다 써버렸다 - Spending all of your money.
돈으로 살 수 있는 것들은 이미 다 샀다 - You’ve bought everything money can buy.
돈을 아끼면 건강도 챙긴다 - Saving money can also take care of your health.
돈은 나갈 때가 있을 뿐 들어올 때는 없다 - Money leaves but never returns.
돈을 잘못 쓰면 배신당한다 - Misusing money can lead to betrayal.
돈은 있어도 쓸 때 없다 - Having money but not using it.
돈에 목숨을 건다 - Betting everything on money.
돈은 원수다 - Money is the root of all evil.
돈은 쓰고 또 써라 - Money should be spent and invested.
돈을 제대로 쓰면 복이 온다 - Properly spending money brings fortune.
가슴에 불이 나다 - To be deeply in love or passionate.
고백하다 - To confess one’s feelings.
눈에 띄다 - To catch someone’s eye.
내 눈에 흙이 들어가기 전에는 - I will keep my promises until my last breath.
들어갈 구멍이 없다 - To be overwhelmed with emotion.
떨어져 있으면 더 그리워진다 - Distance makes the heart grow fonder.
마음이 끌리다 - To feel attracted to someone.
마음에 들다 - To like or be fond of something/someone.
매력을 느끼다 - To feel an attraction or charm.
몽땅 다 사랑에 빠지다 - To fall completely in love.
밥이 고팠던 건 아니다 - It’s not about needing food, but love.
서로 눈을 맞추다 - To gaze into each other’s eyes.
아니면 말고 - No pressure, just take a chance.
애인 같다 - To act like a lover.
열렬히 사랑하다 - To love passionately.
엉킨 실타래 같다 - A tangled, complicated relationship.
연애세포가 없다 - To have no romantic interest.
연애감각이 떨어지다 - To lose one’s romantic touch.
연애에 빠지다 - To fall in love.
우리가 처음 만난 날처럼 - To want to keep the relationship fresh.
이 마음을 어떻게 표현할까 - To wonder how to express one’s feelings.
중독되다 - To become addicted (often to a person).
첫눈에 반하다 - To fall in love at first sight.
커플 같다 - To look like a couple.
확신이 있다 - To be sure of one’s feelings.
한눈에 반하다 - To be struck by love at first sight.
행복이 넘치다 - To be filled with happiness.
행복한 연애 - A happy romantic relationship.
호감을 가지다 - To feel fond of someone.
호감이 가다 - To develop a liking for someone.
다시 만날 때까지 기다리다 - To wait until you meet again.
사랑에 빠지다 - To fall in love.
사랑이 식다 - To fall out of love.
사랑을 고백하다 - To confess one’s love.
사랑에 빠지면 눈에 보이는 게 없다 - Love makes you blind.
상대방의 마음을 얻다 - To win someone’s heart.
서로 눈이 맞다 - To be in love with each other.
손끝에서 전해지는 온기 - The warmth of a lover’s touch.
시간이 지나면 알게 된다 - Time reveals true feelings.
아이처럼 좋아하다 - To like someone like a child.
애틋한 마음 - A tender, deep affection.
엉켜있는 실타래처럼 사랑하다 - To love in a complicated, tangled way.
여자 마음을 모르다 - To not understand a woman’s heart.
오래된 인연 - A long
운명적인 만남 - A fateful meeting.
운명처럼 사랑하다 - To love as if it’s destiny.
이 마음을 전할 방법이 없다 - To not know how to express one’s feelings.
이상형을 만나다 - To meet your ideal type.
자꾸만 생각나다 - To constantly think about someone.
정말 좋아하다 - To truly like someone.
정이 들어서 헤어지기 힘들다 - It’s hard to part because of emotional attachment.
지금 마음은 사랑 중 - To be in love right now.
처음 만났을 때처럼 설레다 - To feel the excitement like when you first met.
친한 사이 - To be close friends, like family.
친구에서 연인으로 발전하다 - To evolve from friends to lovers.
호감이 생기다 - To develop an attraction.
마음이 변하다 - To have a change of heart.
마음을 다하다 - To give your whole heart to someone.
목소리만 들어도 기분 좋아지다 - To feel happy just by hearing someone’s voice.
목소리가 사랑스럽다 - To have a sweet, lovable voice.
문을 열다 - To open up to someone.
믿고 기다리다 - To trust and wait for someone.
사귀다 - To date or be in a romantic relationship.
사랑을 나누다 - To share love with someone.
사랑을 느끼다 - To feel love.
사랑을 지키다 - To protect love.
사랑이란 무엇인가 - What is love?
서로 마음을 나누다 - To share hearts with each other.
소중한 사람 - Someone precious.
순수한 사랑 - Pure love.
아낌없이 주다 - To give without holding back.
아무 말 없이 사랑하다 - To love without saying anything.
안타까운 사랑 - A love that’s full of regret or sorrow.
어떤 마음인지 알다 - To understand someone’s feelings.
언제나 함께하고 싶다 - To want to be together always.
연애 중이다 - To be in a romantic relationship.
연애의 기술 - The skills of love.
예쁜 사랑 - A beautiful love.
예쁜 말로 표현하다 - To express with sweet words.
영원히 사랑하다 - To love forever.
연애 감정을 느끼다 - To feel romantic emotions.
영혼을 나누다 - To share your soul with someone.
오늘도 사랑한다 - To say “I love you” today as well.
좋은 사람 만나세요 - Wishing someone to meet a good person.
좋은 사람을 만나다 - To meet a good person (romantically).
중요한 사람 - An important person in your life.
천생연분 - A match made in heaven.
하늘이 준 사랑 - Love given by heaven.
헤어지고 싶지 않다 - To not want to break up.
함께할 때 행복하다 - To be happy when together.
행복하게 사랑하다 - To love happily.
희망을 주다 - To give hope.
흔한 사랑은 아니다 - It’s not an ordinary love.
혼자 있기 싫다 - To not want to be alone.
가슴이 설레다 - To feel excited or fluttering in the chest.
결혼을 결심하다 - To make a decision to get married.
길고 긴 사랑 - A long
그 사람을 믿다 - To trust that person.
내 마음을 훔치다 - To steal my heart.
눈에 띄게 좋아하다 - To show obvious affection.
다시 사랑을 믿다 - To start believing in love again.
당신에게 빠지다 - To fall for you.
대화가 끊이지 않다 - To have endless conversation, showing comfort with each other.
달콩하다 - To be affectionate or sweet.
든든한 사랑 - A dependable, strong love.
마음을 다 주다 - To give one’s heart completely.
마음을 나누다 - To share one’s feelings or heart.
마음이 설레다 - To feel excited and nervous in love.
몸이 달다 - To be overly affectionate or touchy.
보통의 연애 - An ordinary, normal relationship.
사랑이 시작되다 - Love begins.
사랑에 빠진 것 같다 - I think I’ve fallen in love.
사랑을 믿다 - To believe in love.
사랑의 시작 - The beginning of love.
사랑을 구하다 - To search for love.
사랑을 확인하다 - To confirm or affirm love.
사랑을 기다리다 - To wait for love.
사랑이 나를 기다리다 - Love waits for me.
사랑이 불타다 - To feel love burning strongly.
사랑이 움트다 - Love is blooming.
사랑의 힘 - The power of love.
사랑을 쏟다 - To pour all your love into someone.
사랑을 포기하다 - To give up on love.
사랑이 아프다 - Love hurts.
사랑이 지나가다 - Love passes by.
사랑에 지다 - To lose in love (defeat in love).
상대방에게 사랑을 느끼다 - To feel love from someone.
상대방에게 끌리다 - To feel attracted to someone.
서로 사랑을 나누다 - To share love with each other.
시작은 미약하다 - The beginning is humble, but grows.
애정이 깊어지다 - To deepen one’s affection.
애정을 느끼다 - To feel affection.
애틋한 사랑 - A tender and deep love.
연애가 깊어지다 - To make the relationship more serious.
연애가 시작되다 - A romantic relationship starts.
연애가 끝나다 - A romantic relationship ends.
연애를 즐기다 - To enjoy a relationship.
연애를 못하다 - To be unable to date or have a relationship.
연애를 시작하다 - To begin a relationship.
연애를 고백하다 - To confess love in a romantic relationship.
연애가 복잡하다 - A complicated love life.
연애를 회복하다 - To rekindle a relationship.
연애에 실패하다 - To fail in a relationship.
연애가 달콤하다 - A sweet romance.
연애가 짧다 - A short romance.
연애의 진리 - The truth of love.
연애의 비밀 - The secret of love.
연애의 매력 - The charm of romance.
연애의 기쁨 - The joy of love.
연애의 고백 - A confession of love.
연애에서 배운 것들 - Things learned from love.
연애를 배우다 - To learn about love.
연애를 놓다 - To give up on a relationship.
연애에 빠진 사람 - A person who is in love.
연애를 했다 - To have dated someone.
연애의 시작은 떨린다 - The beginning of love is exciting and nervous.
연애를 하다 - To be in a romantic relationship.
영원한 사랑 - Eternal love.
우리가 함께라서 행복하다 - We are happy because we are together.
위험한 사랑 - A dangerous love.
일편단심으로 사랑하다 - To love someone with all your heart.
자꾸만 좋아지다 - To like someone more and more.
자신을 사랑하다 - To love oneself.
자연스럽게 사랑하다 - To love naturally.
자기만의 사랑 - One’s own unique love.
잘못된 사랑 - A mistaken or wrong love.
자기 마음을 열다 - To open one’s heart.
자주 만나고 싶다 - To want to meet often.
잘 맞는 사람을 만나다 - To meet someone who is a good match.
자신감을 가지다 - To have confidence in love.
작은 일로 싸우다 - To fight over small things in a relationship.
잘 맞는 커플이다 - A well
정말 사랑하다 - To love someone truly.
좋아하는 사람과 함께 있다 - To be with the person you like.
좋은 사람 만나다 - To meet a good person.
좋은 인연이다 - A good connection or relationship.
좋은 추억을 만들다 - To create good memories together.
진심을 다하다 - To give your sincere heart to someone.
지금 사랑하고 있다 - To be in love right now.
기름칠을 하다 - To grease the wheels (smooth things over).
눈을 맞추다 - To lock eyes with someone.
발이 빠르다 - To be quick on your feet.
배를 타다 - To be on the same boat.
불을 지르다 - To add fuel to the fire.
물에 빠지다 - To be in deep trouble.
손이 빠르다 - To be quick with one’s hands.
모래 위에 집 짓기 - Building a house on sand (an unstable foundation).
바람이 불다 - A rumor or situation starting.
톱을 물다 - To hold the top position.
허공에 뜬 소리 - Empty talk (unrealistic).
구름 위를 걷다 - To walk on cloud nine (feel extremely happy).
손톱에 흙이 묻다 - To work hard with your hands.
죽 쒀서 개 준다 - To work hard for no reward.
소리 내어 웃다 - To laugh out loud.
이빨을 드러내다 - To show teeth (to act aggressively).
머리 굴리다 - To use your brain (think hard).
손을 놓다 - To give up (stop working).
돼지 목에 진주 - A waste (casting pearls before swine).
헛다리 짚다 - To misunderstand or do something wrong.
입술이 말라가다 - To struggle to make a point.
발에 땀이 나다 - To be very busy (running around).
고개를 들다 - To lift your head (regain confidence).
말을 아끼다 - To refrain from speaking.
풀어주다 - To relieve or untangle (a problem).
세상에 공짜는 없다 - Nothing in this world is free.
걸음마를 떼다 - To take the first step (begin something).
미꾸라지 한 마리가 개천을 흐리게 한다 - One bad apple spoils the bunch.
귀에 못이 박이다 - To be annoyed by repeated words or actions.
구두쇠 같다 - To be stingy (like a miser).
눈물 젖은 빵을 먹다 - To struggle to survive (living in hardship).
등잔 밑이 어두운 법 - The things closest to you are often the hardest to notice.
코에 걸면 코걸이, 귀에 걸면 귀걸이 - It can be interpreted in many ways.
돌아서다 - To change one’s mind or direction.
저울질을 하다 - To weigh options or choices.
식은 밥이 더 맛있다 - The second time around is better (something old feels new).
눈에서 멀어지면 마음도 멀어진다 - Out of sight, out of mind.
먼 길을 가다 - To go on a long journey (literal or metaphorical).
어쩔 수 없다 - It can’t be helped.
꼬리 잡히다 - To be caught in the act.
물을 흐리다 - To muddy the waters.
얼음 속에 꽃을 피우다 - To bloom under difficult conditions.
강 건너 불 구경 - To be an indifferent onlooker.
돈이 된다고 나서다 - To chase after money.
미친 개가 사과를 물어도 핥지 않는다 - To not take the bait or get involved.
손 안 대고 코 풀기 - To achieve something without effort.
줄줄이 밀려오다 - To come one after another (often problems).
날아가다 - To disappear or be lost.
구름 속에 숨어 있다 - To be hiding from the spotlight.
해도 해도 너무하다 - To push things too far.
사흘 밤낮을 새우다 - To stay awake for days (work hard or study hard).
거미줄에 걸리다 - To get trapped in a situation.
머리가 터지다 - To have a headache (from thinking hard).
거짓말도 여러 번 하면 진짜처럼 된다 - If you repeat a lie enough, it becomes truth.
배에서 물 나오다 - To reach the limit (out of control).
막대기를 휘두르다 - To wield power or control.
눈물의 씨앗을 뿌리다 - To sow the seeds of sorrow (causing future regret).
손에 물이 안 가다 - To not take action or do work.
길게 보면 좋다 - To look at the bigger picture.
꿈을 이루다 - To fulfill a dream.
내 발등을 찍다 - To shoot yourself in the foot (make a mistake).
목이 길어지다 - To anxiously wait for something.
눈을 가리다 - To deceive someone (hide the truth).
양 날개를 펼치다 - To open all opportunities or possibilities.
하늘의 별을 따다 - To achieve the impossible.
마음이 고요하다 - To be calm and at peace.
날카로운 칼날처럼 - To be sharp, both mentally and physically.
불꽃 튀다 - To be in a heated argument or dispute.
가슴이 뜨겁다 - To be emotionally moved or passionate.
저울에 올려놓다 - To weigh the pros and cons.
고민에 빠지다 - To be deep in thought or worry.
돌다리도 두드려 보고 건너라 - Better safe than sorry (test before you act).
노력을 아끼지 않다 - To not spare any effort.
땅에 떨어지다 - To fall from grace, lose respect.
팔을 걷다 - To get ready to work or fight.
입술이 부르트다 - To be caught up in talking or gossiping.
오래된 상처 - A long
입에 발린 소리 - To flatter someone insincerely.
집을 짓다 - To build something, both literally and figuratively.
가슴이 뛰다 - To feel nervous or excited.
차가운 눈빛을 보내다 - To give a cold stare.
구슬이 빠지다 - To lose something valuable (figuratively).
손끝이 닿다 - To be within reach (literally and figuratively).
물어보지 않다 - To not ask for advice or help.
흙 속에 진주 찾기 - To find a rare opportunity or valuable thing.
마음에 둔 사람 - A person someone has feelings for.
구슬이 떨어지다 - To lose one’s place or concentration.
꼬리가 길면 잡힌다 - If you’re involved in something bad, you’ll get caught eventually.
맘에 들다 - To be liked or found satisfactory.
이름값을 하다 - To live up to one’s name or reputation.
온몸이 떨리다 - To shake with fear or excitement.
눈이 떠지다 - To wake up or become aware of something.
우는 아이에게 떡 하나 더 준다 - To reward someone who shows persistence.
입에 물고 다니다 - To keep something secret or silent.
어디에나 있던 사람 - Someone ordinary or common.
눈앞이 캄캄하다 - To be in despair or confusion.
세상은 좁다 - It’s a small world (you keep meeting people you know).
입맛이 돌다 - To develop an appetite or desire for something.
보물 같은 존재 - A precious person or thing.
우리가 같은 길을 가다 - We are on the same path or journey.
손에 안 잡히다 - To be distracted or unfocused.
백문이 불여일견 - Seeing is believing (better to see once than hear a hundred times).
불을 붙이다 - To spark a conflict or situation.
입을 다물다 - To stay silent or keep quiet.
속을 알다 - To know someone’s inner thoughts or secrets.
잘못을 덮다 - To cover up a mistake or error.
자기 입을 지키다 - To keep quiet about something.
바람에 흔들리다 - To be easily swayed or influenced.
손을 빌리다 - To ask for help or support.
배가 고프다 - To be hungry (literally or figuratively).
밑빠진 독에 물 붓기 - To waste your effort.
자랑이 되다 - To be proud of something.
얼굴에 기름칠을 하다 - To flatter or ingratiate oneself.
걸음이 빠르다 - To walk fast or be quick.
미소를 짓다 - To smile.
고집을 부리다 - To insist on something despite resistance.
끝까지 가다 - To go all the way (finish what you start).
시간을 끌다 - To delay or stall.
손끝에 달려 있다 - To be at your fingertips, within easy reach.
땅을 치다 - To regret or feel remorse.
손에 꼽히다 - To be rare or exceptional.
대낮에 강도 맞다 - To be robbed in broad daylight (unexpected misfortune).
사람을 귀하게 여기다 - To treat someone with respect.
손을 쥐다 - To hold onto something tightly (mentally or physically).
얼굴을 붉히다 - To blush from embarrassment.
쥐구멍에 숨다 - To hide from a difficult situation.
해가 지다 - To have a bad day or be in a tough situation.
산을 넘다 - To overcome an obstacle or difficulty.
벼랑 끝에 서다 - To be at the edge of a crisis.
불이 나다 - To start a fire (literal or figurative).
소름이 돋다 - To get goosebumps (from fear or excitement).
다리를 뻗다 - To relax or stretch out.
배꼽을 잡다 - To laugh uncontrollably (literally holding your belly).
소리없이 웃다 - To smile quietly or internally.
피를 토하다 - To express deep frustration or sorrow.
가슴을 열다 - To open your heart.
입을 앙다물다 - To close your mouth tightly.
눈을 찡그리다 - To squint or show disapproval.
길을 떠나다 - To go on a journey or leave.
불행을 넘다 - To overcome misfortune.
하늘을 날다 - To feel on top of the world (extremely happy).
대체로 그러하다 - Generally speaking, that’s how it is.
속이 썩다 - To be corrupted or decaying inside.
심장이 쿵쾅거리다 - To feel your heart pounding with excitement or fear.
철이 없다 - To be immature or naive.
어깨를 떨다 - To shrug your shoulders (show indifference).
팔이 안으로 굽다 - To be biased toward your own side.
눈을 돌리다 - To turn away or avoid looking.
불신을 품다 - To harbor distrust.
속이 깊다 - To be deep or thoughtful.
머리에서 발끝까지 - From head to toe.
날카로운 시선 - A sharp gaze (critical or judgmental look).
눈이 휘둥그레지다 - To widen your eyes in surprise.
하늘을 달리다 - To feel ecstatic or excited.
정신이 없다 - To be absent
어리석은 짓을 하다 - To do something foolish.
마음을 먹다 - To make up one’s mind.
기운이 빠지다 - To feel drained or lack energy.
배가 불러도 - Even though you're full (sometimes used in a context of wanting more).
미련을 남기다 - To leave behind regrets or unresolved feelings.
무언가가 빠지다 - To leave something out or miss an essential point.
마음에 걸리다 - To feel uneasy or bothered.
세상을 떠나다 - To pass away.
입이 방정이다 - To speak too much or speak out of turn.
코를 골다 - To snore.
속이 편안하다 - To feel at peace or relieved.
동이 나다 - To run out of something (resources, supplies).
간을 보다 - To test the waters.
뒷모습이 남다 - To leave a lasting impression.
머리로는 알지만 - To understand with your head but not with your heart.
발길을 돌리다 - To turn away or change direction.
입에 풀칠하다 - To scrape by, make do with little.
손이 많이 가다 - To require a lot of effort or work.
눈앞이 깜깜하다 - To be completely in the dark or confused.
길을 열다 - To open the way for others.
얼굴을 내밀다 - To show your face, become visible in a situation.
해가 저물다 - The day is ending (metaphorically, a situation is wrapping up).
배에 손을 얹다 - To rest or take a break.
손끝에 달리다 - To be within reach, easily attainable.
골칫거리가 되다 - To become a problem or nuisance.
손에 들고 다니다 - To carry something around (like an object or responsibility).
하늘에 별 따기 - To attempt the impossible.
두 눈을 떴다 - To wake up or become aware of something.
가슴이 두근거리다 - To feel anxious or excited.
입이 다물어지지 않다 - To be unable to stop talking.
손을 대다 - To touch or start something.
피를 마시다 - To face adversity or hardship.
끝을 보다 - To finish something or see it through.
기대를 저버리다 - To disappoint someone’s expectations.
얼굴을 찡그리다 - To grimace or frown.
발을 헛디디다 - To stumble, make a misstep.
머리가 띵하다 - To have a headache or feel overwhelmed.
마음이 녹다 - To soften one's heart, be touched.
칼날 위를 걷다 - To walk a fine line, be in a dangerous position.
속이 들여다보이다 - To be transparent or easy to read.
팔을 걷어붙이다 - To roll up your sleeves and get to work.
허리가 아프다 - To be weighed down by heavy responsibility.
달걀에 물 넣다 - To put effort into something with little result.
눈을 똑바로 뜨다 - To open your eyes wide, be alert or aware.
뼈를 깎다 - To put in a great amount of effort or sacrifice.
기회를 놓치다 - To miss an opportunity.
손톱에 물이 묻다 - To be involved in hard work or manual labor.
마음을 담다 - To put your heart into something.
발에 채이다 - To be bogged down or hindered by something.
고비를 넘기다 - To overcome a difficult situation.
마음이 따뜻하다 - To be kindhearted or warm.
울면서 웃다 - To smile through tears, mixed feelings.
주머니가 가벼워지다 - To run out of money.
모래 위에 집을 짓다 - To build something on unstable ground (futile effort).
가슴을 쥐다 - To hold your heart (feel emotionally moved).
입을 막다 - To keep quiet or silence someone.
숨을 고르다 - To catch your breath, relax for a moment.
입에 달다 - To speak smoothly or flatter.
길을 나서다 - To set off on a journey.
기회를 얻다 - To gain an opportunity.
마음이 부풀다 - To feel excited or elated.
불을 끄다 - To extinguish a fire or end a heated situation.
엉덩이를 들다 - To get up and take action.
손에 물 묻히다 - To do something with your own hands, to work.
손에 쥐다 - To hold something firmly, often symbolizing control.
길을 헤매다 - To wander or lose your way.
눈을 감다 - To close your eyes (either to sleep or die).
배에 짐을 지다 - To carry a heavy burden or responsibility.
손목을 돌리다 - To use your hands skillfully (literal or metaphorical).
가슴에 품다 - To harbor feelings, keep something in your heart.
미래를 보다 - To foresee or plan for the future.
길을 막다 - To block someone's way or hinder progress.
마음을 열다 - To open your heart, become receptive.
나무를 보지 말고 숲을 보라 - Don’t focus on the small details, look at the bigger picture.
무릎을 꿇다 - To kneel or submit.
팔을 뻗다 - To reach out or extend your help.
기회를 살리다 - To make the most of an opportunity.
입을 열다 - To speak or begin to talk.
거북이 걸음 - To move slowly (like a turtle’s pace).
눈을 흘기다 - To glance sideways, usually in anger or jealousy.
마음을 달래다 - To soothe or calm your mind.
사람을 만나다 - To encounter or meet people.
가슴이 따뜻해지다 - To feel moved or emotionally touched.
하늘을 나는 기분 - To feel like you're on top of the world.
속이 시원하다 - To feel refreshed or relieved.
손을 뻗다 - To reach out or make an effort.
고삐를 잡다 - To take control or manage a situation.
눈을 번쩍 뜨다 - To open your eyes wide in realization or shock.
기분이 풀리다 - To feel relieved, as in after a stressful situation.
별을 따다 - To achieve something extraordinary.
손이 빨라지다 - To act quickly or be very efficient.
팔에 물집이 생기다 - To get blisters from hard work.
눈을 떠보니 - To realize something after it happens, wake up to reality.
머리가 아프다 - To have a headache (often metaphorically, from stress).
물에 빠진 사람 건지기 - To offer help to someone in need.
살을 에다 - To cut through something sharply (literally or metaphorically).
배를 채우다 - To eat or fill your stomach.
밑에 눕다 - To lie down, often used in the context of resting.
바람을 쐬다 - To get some fresh air or clear your mind.
꿈을 꾸다 - To dream (literally or metaphorically).
주머니에 손을 넣다 - To have money in your pockets or be wealthy.
목을 길게 하다 - To eagerly wait or anticipate something.
머리를 돌리다 - To change your mind or direction.
서로 손을 맞잡다 - To join hands, cooperate.
눈치를 보다 - To observe or check others' reactions.
마음에 담다 - To keep something in your heart, care for something deeply.
발을 멈추다 - To stop in your tracks, hesitate.
어깨를 짓누르다 - To feel the burden or pressure of responsibility.
기운을 차리다 - To regain energy or composure.
마음을 쥐다 - To hold someone’s feelings or control a situation.
손에 물이 묻다 - To engage in hard work or get dirty.
꿈이 이루어지다 - To see your dreams come true.
몸이 가벼워지다 - To feel lighter or more at ease.
고삐를 당기다 - To tighten control or restrict.
눈이 가다 - To be attracted or drawn to something.
마음이 가다 - To be emotionally moved or attracted to something.
피가 마르다 - To be thirsty or feel drained.
손톱에 물 묻다 - To be involved in hard work or labor.
입에 물어보다 - To ask someone a question, inquire.
마음을 놓다 - To feel relieved or at ease.
바람에 날리다 - To be blown away, either physically or emotionally.
숨을 쉬다 - To take a breath, to relax.
손을 맞잡다 - To cooperate, join hands.
두 눈을 부릅뜨다 - To open your eyes wide in surprise or alertness.
어깨를 움츠리다 - To shrink or bow down due to pressure or fear.
손끝에 닿다 - To reach or attain something with ease.
목을 빼다 - To eagerly await something.
몸이 무겁다 - To feel physically exhausted or tired.
하늘을 보다 - To look at the sky (dream or imagine big possibilities).
몸을 던지다 - To throw oneself into something, to commit fully.
길을 비우다 - To make way for someone, give way.
머리를 굽히다 - To bow down in respect or submission.
손끝에 물이 묻다 - To work hard, to be involved in manual labor.
팔이 저리다 - To feel numb or tired from extended effort.
발을 들이다 - To make an entrance or start something new.
목에 걸다 - To risk or dedicate everything to something.
발을 묶다 - To be restricted or restrained in your actions.
기회를 잡다 - To take hold of an opportunity.
입을 아끼다 - To speak carefully or avoid unnecessary speech.
길을 묻다 - To ask for directions, to inquire about the way.
눈이 번쩍 뜨다 - To open your eyes wide in surprise or shock.
팔을 쭉 뻗다 - To stretch out your arm or extend a gesture.
팔을 저리다 - To feel numb or tired from use.
발을 디디다 - To step into or begin something.
눈을 치우다 - To clear up confusion or misunderstandings.
발을 담그다 - To dip your feet, start trying something new.
손을 묶다 - To be restricted or unable to act.
기회를 만들다 - To create or make an opportunity.
몸을 돌리다 - To change direction or shift focus.
입을 떼다 - To start talking or speaking.
손을 내밀다 - To extend a hand, offer help.
입을 가리다 - To cover your mouth, keep silent.
팔이 길어지다 - To reach further, extend your ability to achieve something.
발을 딛다 - To take a step or begin something new.
몸을 풀다 - To loosen up, stretch before doing something.
고개를 돌리다 - To turn away or avoid something.
몸을 놓다 - To relax or let go of tension.
발을 빨다 - To be very quick or energetic.
기운을 내다 - To gather strength, to cheer up.
팔을 휘젓다 - To wave your arms or make big motions.
몸을 굳히다 - To stiffen up, to become tense or rigid.
발을 떼다 - To step away, move on, or disengage.
목이 빠지다 - To eagerly wait or anticipate.
손끝에 물 묻다 - To do hard work, get your hands dirty.
눈을 반짝이다 - To shine with excitement or enthusiasm.
몸을 떼다 - To get up and start moving, take action.
목을 돌리다 - To turn away or change focus.
기회를 노리다 - To wait for the right moment or opportunity.
손을 빼다 - To withdraw, remove yourself from a situation.
